111111
100S01
100001
100101
100001
111G11
